**************************************************
*      *           ***            *              *
*      *   * * **   **        *   *    *    *    *
****   *   *   ***   **********   *    *      *  *
*          *   ****      ******   *   ******     *
*      *****          *           *   *          *
*             ******  *  * *   *  *   ******     *
****  ******   ****   *    * * *                 *
*     *    *    ***   *    *   *  *****          *
****  *    *     **   *    *   *                 *
*                          *   *                 *
**  **   *  *   *  **  ****    * ** **** ** * ** *
*   ***  *      *   *                * * ** * ** *
*     *  *      *** *******    ***     * ** * ** *
*   ***  *        * *******    ***     * ** * ** *
*   ***  *        * *                            *
*   *      *                   ********* *********
**  ****      ** ******    *        ****         *
**     *   *  *   *****    *      * ************ *
**  *  ** **  *     ***    ******** ************ *
*   *     **      *****                          *
**************************************************
